9 9
11111111111
10000000011
11111111101
11000000011
10111111111
11000000011
11111111101
11000000011
10111111111
11000000001
11111111111